00000100000
00000100000
01111111000
01001001110
01101101000
00100101110
00110101000
00010101000
00000001000